*********
*     * *
* ***** *
* * *   *
* * *** *
*  <*   *
*** * * *
*     * *
******* *
