*********
*     * *
* * *** *
* * *   *
* * *** *
* *v*   *
* * * * *
*     * *
******* *
