* *******
*     * *
* ***** *
* * *   *
* * *** *
*  ^*   *
*** * * *
*     * *
******* *
